##################################################
#S.....#........#..........#........#............#
#.###.#.#######.#.########.#.######.#.##########.#
#...#.#.......#.#.#....#...#........#...#........#
###.#.#######.#.#.#.##.#.#############.#.######.#.
#...#.........#.#.#.#...#.#..........#.#.#......#.
#.#####.#######.#.#.#####.#.########.#.#.#.#######
#.#.....#.......#.#.#.....#.#......#.#.#.#.......#
#.#.###.#.#####.#.#.#.#####.#.####.#.#.#.#########
#.#.#...#.#...#.#.#.....#...#.#..#.#.#.#.#.......#
#.#.#.#####.#.#.#.#######.###.##.#.#.#.#.#####.#.#
#.#.#.......#.#.#.........#...#...#.#.#.#.....#.#.
#.#####.###.#.#.###########.###.###.#.#.#.#####.#.
#.#.....#.#.#.#.#.........#.....#...#.#.#.#.....#.
#.#######.#.#.#.#.#######.#######.###.#.#.###.###.
#.........#.#.#.#.#.....#.......#...#.#.#.#...#.#.
#.#######.#.#.#.###.###.#######.###.#.#.#.#.###.#.
#.....#...#.#.#.....#.#.#.....#.#...#.#.#.#.#...#.
#.###.#.###.#.#####.#.#.#.###.#.#.###.#.#.#.#.#.#.
#.#.#.#.....#.....#...#.#.#.#.#.#.#...#.#...#.#.#.
#.#.#.###########.###.###.#.#.#.#.#.###.#####.#.#.
#.#.#.#.....#...#.#.#.#...#.#.#.#.#.#.#.#.....#.#.
#.#.#.#.###.#.#.#.#.#.#.###.#.#.#.#.#.#.#.#####.#.
#.#...#.#...#.#.#...#.#...#.#.#...#.#.#.#.#.....#.
#.#####.#.###.#.#####.#.#.#.#.#####.#.#.#.#.#####.
#.#.....#.#.#.#.....#.#.#...#...#...#.#.#.#.....#.
#.#.###.#.#.#.#####.#.#######.#.#.###.#.#######.#.
#.#.#...#.#.....#...#.......#.#.#.#...#.........#.
#.#.#.###.#######.###.#####.#.###.#.###.#########
#.#.#.#.....#.#...#.....#...#.....#.#...#........#
#.#.###.###.#.#####.###.#.#########.#.#.#.#######.
#.#.....#...#.#.....#.#.#.#.........#.#...#.....#.
#.#######.###.#.#.###.#.#.#.#############.###.###.
#...#...#.#...#.#.#...#.#.#...............#.....#.
###.#.#.#.#.###.###.###.#.#####################.#.
#...#.#.#.#...#.....#...#.#.....................#.
#.###.#.#.###.###.#.#####.#.###################.#
#.#...#.#.#...#...#...#...#.#.............#.....#.
#.#.#.#.#.#.###.#####.#.#.#.#.###########.#.###.#.
#...#.#.#.#...#.....#.#.#.#.#.#...#.....#.#.#...#.
#####.#.#.###.#.#####.###.#.#.#.#.#.###.#.#.#.#.#.
#.....#.#.#...#.......#...#.#.#.#.#.#...#.#.#.#.#.
#.#######.#.###########.###.#.#.#.#.#####.#.#.#.#.
#.#.......#.#.........#...#.#...#.#.#.....#...#.#.
#.#.#######.#.#######.###.#.#####.#.#.#########.#.
#.#.........#.....#.....#.#.......#.#.#.........#.
#.#############.###.#####.#.#########.#.#######.#.
#..............#.....#....F.........#...........#
##################################################